1011111111011111
1000001100000000
1101101120110111
0000001111100000
1111100001101101
0011111100001101
1011020101101101
1011010101000021
1000000001011011
1111111111011011
0001111000000011
0403000011111111
0001111011111000
1111110000011011
1110000111000211
1112111100011111