1011111111011111
1000000000000001
1000000000000001
1000001111100000
1000000000000001
0011111100001101
1011020101100001
1011010101000021
1000000001011011
1000000000001001
1001111000000001
1403000011111111
1000000000000001
1000000000000001
1000000000000001
1111111111111111